("I", "1")
("i", "1")
("E", "3")
("e", "3")
("E", "£")
("e", "£")
("S", "$")
("s", "$")
("S", "5")
("s", "5")
("A", "@")
("a", "@")
("o", "0")
("O", "0")
("l", "1")
("L", "1")
("at", "@")
("ate", "8")
("for", "4")
("a", "A")
("A", "a")
("b", "B")
("B", "b")
("c", "C")
("C", "c")
("d", "D")
("D", "d")
("e", "E")
("E", "e")
("f", "F")
("F", "f")
("g", "G")
("G", "g")
("h", "H")
("H", "h")
("i", "I")
("I", "i")
("j", "J")
("J", "j")
("k", "K")
("K", "k")
("l", "L")
("L", "l")
("m", "M")
("M", "m")
("n", "N")
("N", "n")
("o", "O")
("O", "o")
("p", "P")
("P", "p")
("q", "Q")
("Q", "q")
("r", "R")
("R", "r")
("s", "S")
("S", "s")
("t", "T")
("T", "t")
("u", "U")
("U", "u")
("v", "V")
("V", "v")
("w", "W")
("W", "w")
("x", "X")
("X", "x")
("y", "Y")
("Y", "y")
("z", "Z")
("Z", "z")